G G G G G G G G G G
G P P P G G G B B G
G P G P G G G B B G
G P G P P P P G G G
G P G G G G P G G G
G P P P P G P G G G
G G G G P G P G G G
G B B G P G G G G G
G B B G P P P P P G
G G G G G G G G G G
